2 0 3 0 3
0 3 2 2 0
0 2 4 1 0
5 0 0 0 0
3 5 0 0 0
6 0 0 0 0
2 2 0 0 3
3 2 0 3 0
0 3 5 0 0
0 5 0 0 0
0 0 2 4 1
0 6 0 0 0
3 0 0 2 2
0 3 2 0 3
1 0 0 2 4
0 0 0 0 5
0 0 0 3 5
0 0 6 0 0
2 2 3 0 0
3 0 3 2 0
4 1 0 0 2
0 0 5 0 0
5 0 0 0 3
0 0 0 6 0
0 3 0 3 2
0 0 2 3 2
2 4 1 0 0
0 0 3 5 0
0 0 0 5 0
0 0 0 0 6