0 3 5 3 3
3 6 3 0 0
0 7 0 0 0
3 7 0 0 0
3 0 3 5 3
0 0 7 0 0
0 3 6 3 0
0 3 7 0 0
3 3 0 3 5
0 0 0 7 0
0 0 3 6 3
0 0 3 7 0
5 3 3 0 3
0 0 0 0 7
3 0 0 3 6
0 0 0 3 7
3 5 3 3 0
7 0 0 0 0
6 3 0 0 3
7 0 0 0 3