3 gE 0 3 5 3 3
4 gE 3 6 3 0 0
4 gE 0 7 0 0 0
5 gE 3 7 0 0 0
3 bS 3 0 3 5 3
4 bS 0 0 7 0 0
4 bS 0 3 6 3 0
5 bS 0 3 7 0 0
3 wD 3 3 0 3 5
4 wD 0 0 0 7 0
4 wD 0 0 3 6 3
5 wD 0 0 3 7 0
3 bO 5 3 3 0 3
4 bO 0 0 0 0 7
4 bO 3 0 0 3 6
5 bO 0 0 0 3 7
3 rR 3 5 3 3 0
4 rR 7 0 0 0 0
4 rR 6 3 0 0 3
5 rR 7 0 0 0 3