1 gE 2 0 3 0 3
1 gE 0 3 2 2 0
2 gE 0 2 4 1 0
2 gE 5 0 0 0 0
2 gE 3 5 0 0 0
3 gE 6 0 0 0 0
1 bS 2 2 0 0 3
1 bS 3 2 0 3 0
2 bS 0 3 5 0 0
2 bS 0 5 0 0 0
2 bS 0 0 2 4 1
3 bS 0 6 0 0 0
1 wD 3 0 0 2 2
1 wD 0 3 2 0 3
2 wD 1 0 0 2 4
2 wD 0 0 0 0 5
2 wD 0 0 0 3 5
2 wD 0 0 6 0 0
1 bO 2 2 3 0 0
1 bO 3 0 3 2 0
1 bO 4 1 0 0 2
2 bO 0 0 5 0 0
2 bO 5 0 0 0 3
3 bO 0 0 0 6 0
1 rR 0 3 0 3 2
1 rR 0 0 2 3 2
2 rR 2 4 1 0 0
2 rR 0 0 3 5 0
2 rR 0 0 0 5 0
3 rR 0 0 0 0 6