0 gE 0 1 2 0 0
0 gE 0 2 0 0 2
0 gE 1 3 1 0 0
0 gE 0 1 1 1 1
0 gE 0 1 1 2 1
0 gE 0 1 0 2 2
0 gE 0 0 0 0 3
1 gE 0 0 0 4 0
0 bS 0 0 1 2 0
0 bS 1 0 1 1 2
0 bS 1 0 1 1 1
0 bS 3 1 0 0 1
0 bS 0 0 0 3 0
0 bS 2 0 1 0 2
0 bS 2 0 0 2 0
1 bS 0 0 0 0 4
0 wD 2 2 0 1 0
0 wD 0 0 0 1 2
0 wD 1 1 0 1 1
0 wD 0 3 0 0 0
0 wD 0 2 0 2 0
0 wD 2 1 0 1 1
0 wD 0 1 3 1 0
1 wD 4 0 0 0 0
0 bO 1 1 1 0 1
0 bO 2 0 0 0 1
0 bO 2 0 2 0 0
0 bO 1 0 0 1 3
0 bO 3 0 0 0 0
0 bO 1 2 1 0 1
0 bO 0 2 2 0 1
1 bO 0 4 0 0 0
0 rR 0 0 3 0 0
0 rR 0 0 1 3 1
0 rR 1 2 0 0 0
0 rR 1 0 2 2 0
0 rR 1 1 2 1 0
0 rR 1 1 1 1 0
0 rR 0 0 2 0 2
1 rR 0 0 4 0 0